usa=美国
britain=英国
australia=澳大利亚
japan=日本
germany=德国
italy=意大利
france=法国
sovietUnion=苏联
netherlands=荷兰
canada=加拿大
poland=波兰
finland=芬兰
thailand=泰国


distanceUnits=mm|m|km|"|'|yd|NM
tons= 吨
kilograms= 千克
pounds= 磅
inches= 英寸
metres= 米
feet= 英尺
yards= 码
kiloyards= 千码
kilometres= 千米
nauticalMiles= 海里
millimetres= 毫米
knots= 节
decibel= 分贝
seconds= 秒
minute= 分
hour= 时
degrees=°
percent=%
crew=船员
inClass=同级数量
dimensions=尺寸
weight=重量
displacement=排水量
maxSpeed=最高航速
testDepth=最大深度
ceiling=最大限高
weapons=武器:
class=级
Submarine=潜艇
Destroyer_Escort=护航驱逐舰
Destroyer=驱逐舰
Light_Cruiser=轻巡洋舰
Heavy_Cruiser=重巡洋舰
Battlecruiser=战列巡洋舰
Battleship=战列舰
Light_Carrier=轻型航母
Aircraft_Carrier=航母
Oiler=油船
Merchant=运输船
Scout=侦察机
Fighter=战斗机
Dive_Bomber=战斗机
Torpedo_Bomber=鱼雷机
Medium_Bomber=中型轰炸机
Heavy_Bomber=重型轰炸机
Multiplied=x
Torpedo=鱼雷
DepthCharge=深弹
Hedgehog=刺猬弹:
Squid=乌贼弹:
Fixed_Guns=固定机枪:
Bomb=航弹:
Aerial_Torpedo=空投鱼雷:
Aerial_Depth_Charge=空投深弹:
Rocket=火箭弹:
Armor=装甲:
Belt=装甲带
Deck=甲板
Turret=炮塔
Magazine=弹药库
Superstructure=上层建筑
Sensors=探测
SurfaceRadar=水面雷达
AirRadar=对空雷达
PassiveSonar=被动声纳
ActiveSonar=主动声纳
ESM=ESM
Range=射程
Calibre=口径
ReloadTime=装弹
DualPurpose=高平两用
Yes=是
No=否
ActionReport=报告
ActionReportHeader=作战报告
ActionReportDamage=损伤
ActionReportFlooding=进水
ActionReportTotalSunk=总击沉:
ActionReportAir=飞机:
ActionReportAirLost=损失:
ActionReportTons=吨
ActionCommandPoints=获得指挥点:

UnitIDNext=检视下一个
UnitIDPrev=检视上一个
UnitIDClassifyAs=将目标识别为
AllSubtypes=全部

TypeSea=舰船
TypeSubmarine=潜艇
TypeAir=飞机

NoTarget=无目标
ControlledUnitHeader=\n速度:        航向:        <0>
TargetUnitHeader=解算:         方位:        距离:\n速度:        航向:        <0>
InfoDepth=深度:
InfoAltitude=高度:
NoData=---

Formation=队形
Combat=战斗

Status=状态
DamageControlTitles=损伤\n进水\n速度\n转向\n效率
ArmorPiercing=AP
HighExplosive=HE
StarShell=SS
SpreadLoose=宽散布
SpreadFull=标准散布
SpreadNarrow=窄散布
ManualFire=手动
SpottingFire=校射
AtWillFire=自动
WeaponFire=开火
WeaponHold=暂停
WeaponCease=停止
SubsystemNames=普通舱室,主炮,副炮,鱼雷,深弹,刺猬弹,乌贼弹,舰桥,控制室,指挥室,舰载机,烟囱,弹药库,鱼雷舱,引擎舱,发电机舱,螺旋桨,螺旋桨,舵机,螺旋桨&舵机,围壳
DetailPanelTitles=血量,装甲,鱼雷防御,轮,鱼雷,剩余
VerticalArmor=垂直:
HorizontalArmor=水平:
NoArmor=无
Status0=无
Status1=轻微
Status2=中度
Status3=严重
Status4=致命
Reloading=装弹中
TubesReady=发射管就绪:
AircraftTarget=飞机
ManualPosition=固定点

ScuttleShip=自沉
Confirm=确认
StatusSunk=沉没
StatusScuttled=自沉
Vulnerable=防御减益:     <0>
VulnerableType0=鱼雷
VulnerableType1=补给
VulnerableType2=建筑材料
VulnerableType3=燃料
VulnerableType4=空袭
VulnerableBridge=没有舰桥
VulnerableControl=没有控制室

Conditions=环境
NoLayer=无温跃层
Objectives=目标
ConditionsHeaders=天气\n可视度\n海况\n风速\n风向\n\n温跃层深度\n温跃层强度\n导音强度
Disengage=撤退
CanDisengage=脱离
DisengageIn=脱离中:

FormationBreak=解散
FormationFormUp=编入
FormationFollow=跟随
CombatAttack=攻击
CombatAid=支援
CombatCease=停止
CombatRadarSet=雷达
CombatSonarSet=声纳

PeriscopeDepth=潜望镜深度
CrashDive=紧急下潜
BlowBallast=浮出水面
Periscope=潜望镜
SilentRunning=静音潜航
Gear=起落架
BombDoors=投弹舱门
AllDrop=投下全部

SignatureSizes=很大,大,中,小,很小
SonarSizes=很吵,吵,中,静,很静

MainDirector=主指挥室
ControlRoom=控制室
AltDirector=副指挥室
Settings=射击指令
Target=目标:
Solution=解算:
NoSolution=无\n拦截
StopTracking=停止
FireAtWill=自动射击
FireAtWillTarget=目标:

UnitTypes=潜艇,护航驱逐舰,驱逐舰,轻巡洋舰,重巡洋舰,战列巡洋舰,战列舰,轻型航母,航母,油船,运输船,侦察机,战斗机,战斗机,鱼雷机,中型轰炸机,重型轰炸机
UnitTypeAbbreviations=SS,DE,DD,CL,CA,BC,BB,CVE,CV,AO,MS,S,F,DB,TB,MB,HB
ShellTypes=AP,HE,SS

GunDisplay=型号\n数量\n口径\n射程\n高平两用\n装弹时间
TorpedoDisplay=型号\n数量\n射程\n速度\n装弹时间
ASWDisplay=型号
RefPrimary=主炮
RefSecondary=副炮
RefTorpedo=鱼雷
RefASW=反潜
RefVisible=隐蔽&雷达
RefSonar=噪音&声纳
RefArmor=装甲
RefVArmor=垂直
RefHArmor=水平
RefVisibleHeaders=\n隐蔽距离\n被目视侦测\n被雷达侦测\n水面雷达\n对空雷达
RefSonarHeaders=\n噪音\n被主动声纳侦测\n被动声纳\n主动声纳
RefArmorHeaders=\n装甲带\n甲板\n弹药库\n炮塔\n舰桥\n上层建筑\n鱼雷防御
RefArmorPen=穿深
RefAirOnBoard=飞机搭载

ShipDataShells=炮弹
ShipDataTorpedo=鱼雷
ShipDataDepthCharge=深弹
ShipDataTDS=鱼雷防御
ShipDataDamaged=损伤
ShipDataFlooded=进水
ShipDataCargo=货物
ShipDataCargoNames=部队|补给|建筑材料|燃料

followingWaypoints=跟随路径点
followingUnit=编队于
attackingUnit=攻击
evading=规避
depthChargeTarget=深弹攻击
noAction=无
escortNobody=无

WeatherNames=晴天,多云,阴晴不定,阴天,雨天,风暴,雪天,暴风雪

Continue=确定

//Tooltips
Statistics=基础信息
Weapons=武器
AntiAircraft=防空
SensorsArmor=探测&装甲
AirOnBoard=载机
CounterFlood=反向注水
AutoDC=自动分配损管
SwitchSeaAir=选择 海/空
FilterNation=阵营筛选
FilterSubtype=舰种筛选
SelectAll=选择全部/取消选择
SelectSeaClass=选择船级
SelectAirClass=选择飞机型号
ShipsInClass=同级船
AutoAAA=自动防空
LaySmoke=施放烟幕
AutoEvade=自动规避
AutoGunnery=自动射击
AutoDogfight=自动狗斗
RadarToggle=雷达
ActiveSonarToggle=主动声纳
SearchlightToggle=探照灯

IntelSea=舰船|航向:|速度:|推测:|(护航)

//Main Menu
Training=教程
SingleMission=单场战斗
CustomMission=自定义战斗
Campaign=战役
CampaignLoad=加载战役
CampaignSave=保存战役
Museum=图鉴
Options=设置
Credits=制作组
Quit=退出
Version=版本
Copyright=

Game=游戏
HideShells=不显示炮弹
NewLead=自动顶替领队
MapIntercept=小地图显示瞄准目标
MapBombsight=小地图显示投弹落点
AutoClassify=高解算时自动识别船级
AIFriendly=敌方友伤
AISeaCol=敌方碰撞伤害
PlayerFriendly=玩家友伤
PlayerSeaCol=玩家碰撞伤害
DudTorpedoes=鱼雷存在哑弹
DudBombs=航弹存在哑弹
StratMapSpeed=地图拖拽惯性
UseMetric=使用公制单位
UnlimitedCamera=可检视未被点亮的目标
DifficultyCombat=战斗难度
DifficultyCampaign=战役难度
DifficultyOptions=新手,简单,正常,困难,精英
SonarSensitivity=声呐灵敏度
SonarSensitivityOptions=1x,2x,3x,4x

AISubmarines=敌方使用潜艇
AICarriers=敌方使用航母
ReplenishCarriers=舰载机需要回港补充
RefundPostRepair=维修时返还指挥点

Difficulty=难度
DifficultyTitles=Modifier (Default 1)				玩家			敌方
BaseEfficiency=基础效率
ShellDamage=炮弹伤害
TorpedoDamage=鱼雷伤害
BombDamage=炸弹伤害
ASWDamage=深弹伤害
RepairTimeMod=维修时间
ReloadTimeMod=装弹时间
MaxSolution=最大解算
TorpedoDefense=鱼雷防御
AircraftAbsorb=飞机吸收伤害
VisualRange=目视距离
RadarRange=雷达距离
SonarRange=声纳距离

Audio=音频
MasterVolume=主音量
EffectsVolume=音效音量
MusicVolume=音乐音量
VoiceVolume=语音音量
LogVolume=战斗日志音量
CampMessageVolume=战役消息音量
MusicInCombat=战斗时播放音乐

Video=画面
FullScreen=全屏
Resolution=分辨率
AntiAliasing=抗锯齿
AntiAliasingOptions=关,2x,4x,8x
VSync=垂直同步
Terrain=显示地形
Trees=显示树木
ColorFilter=滤镜后处理
Bloom=照明后处理
Shadows=阴影
UnderParticles=水下粒子
OceanQuality=海面质量
OceanQualityOptions=低,中,高,最高
//FarWaves=Far Waves
Tooltips=提示
TooltipOptions=全部,关键,关闭
UIScale=UI大小:
ComplexSearchlights=高级探照灯特效

Controls=控制
InvertMouse=反转鼠标
CameraSensitivity=视角移动灵敏度
RestoreDefault1=默认数字键控制
RestoreDefault2=默认WASD控制

StartCombat=开始

Back=返回
Start=开始
Load=加载
Delete=删除
Save=保存
Overwrite=覆盖
SavedConfirm=保存到:
FileExists=已存在，是否覆盖?
NewFileName=新建文件:
QuitCombat=退出
Apply=应用
GameManual=游戏手册
CampaignSettings=战役设置

Theatres=太平洋,大西洋,印度洋,地中海

January=一月
February=二月
March=三月
April=四月
May=五月
June=六月
July=七月
August=八月
September=九月
October=十月
November=十一月
December=十二月

[CAMPAIGN]
AutoSaveName=Autosave.txt
FormationLabels=1.|2.|3.|4.|5.|6.|7.|8.|9.|10.|11.|12.
CPlayerPoints=指挥点:
CSummary=战役概况
CSummaryUnits=单位
CSummaryLocations=地点
CSummaryRepair=修整
CSummarySunk=我方损失
CSummarySunkEnemy=敌方损失
CUnitsHeaders=舰名||种类||所处编队||舰载机|# 损伤舱室数量
CSunkUnitsHeaders=舰名||种类||沉没日期||吨位||
CLocationsHeaders=名称||港口等级|机场等级|驻扎人数|补给|建筑材料|燃料
CRepairsHeaders=舰名||种类||||修整剩余天数||
CTotalShips=总沉没数量:
CTotalTons=总沉没吨位:
CTotalAircraft=总飞机损失:
CMobileOrders1=交换位置|移出编队|加入编队|修整
CMobileOrders2=管理货物|起飞飞机|炮击|卸下所有货物|补充所有弹药
CMobileCourse=设定路线
CMobileSplit=移出
CMobileMerge=加入
CMobileDisband=修整
CMobileSwap=交换位置
CMobileCargo=货物
CMobileWorld=战术视角
CMobileAirStrike=AIRCRAFT
CMobileUnload=卸下
CMobileRemove=移除
CMobileDone=完成
CMobileReturnToBase=返航
CMobileLand=降落
CMobileAirHeaders=数量\n隶属\n续航\n\n挂载\n可用\n\n护航
CLocBuyShip=部署舰船
CLocAircraft=部署飞机
CLocHeaders=部队\n补给\n建筑材料\n燃料
CLocUpgrade=补给\n建筑材料\n燃料
CLocCreateSea=部署舰船
CLocCreateAir=部署飞机
CTaskForce=TASK FORCE
Cost=花费:
Available=可用:
CShipSpeeds=极低航速(不到8节)|低航速(8-12节)|中等航速(12-16节)|高航速(16-20节)|极高航速(22+节)
CMapKey=图例
CRules=规则
AirLaunchData=航程:   <0>               起飞冷却:   <1>
CampaignWeekly=每周
CampaignDaily=每日
CampaignPostRepair=(满血)
UnknownShipName=???
CurrentDay=天数:

OwnedPrefix=(已部署)
UnavailablePrefix=(不可用)
SunkPrefix=(沉没)
RepairPrefix=(修整剩余<0>)

NewMapNote=新地图标记

CEngagementHeader=遭遇战
CEngagementTitles=编队:|日期:|时间:|天气:|海况:
CIgnore=跳过
CAutoResolve=自动解决
CStartEngagement=开始
CGoTo=前往

CombatLoad=载入游戏
CombatSave=保存游戏

DescriptionGeneral=在区域内寻找和攻击敌军
DescriptionBombard=进行舰炮对岸炮击\n需要战列舰、战列巡洋舰或重巡洋舰\n- 炮击该地点所有设施\n- 口径越小的舰炮造成的伤害越小
DescriptionMuseum=Examine Units.\n\nUse the Recognition Manual to browse various ships and aircraft.\nTake control of each unit using "Select Unit".

[EDITOR]
Factions=玩家|敌人|中立
SeaState=海况
Heading=航向:
Speed=速度:
Depth=深度:
Altitude=高度:
SeaStates=0|1|2|3|4|5|6|7|8
Headers=日期\n时间\n天气\n海况\n玩家阵营:
EngagementSettings=自定义设置
Skirmish=自定义战斗
SkirmishLoad=加载自定义战斗
SkirmishSave=保存自定义战斗
Sea=海上
Air=空中
Minutes=00|05|10|15|20|25|30|35|40|45|50|55
Hours=00|01|02|03|04|05|06|07|08|09|10|11|12|13|14|15|16|17|18|19|20|21|22|23
Months=一月|二月|三月|四月|五月|六月|七月|八月|九月|十月|十一月|十二月
Years=1938|1946
DecimalDegrees=海域坐标Y/X
ClearAll=清除所有

ClearOptions=恢复默认设置并重启?

[PAUSE]
PausePaused=暂停
PauseResume=继续
PauseSave=保存游戏
PauseBackToMain=返回主菜单
PauseQuit=退出游戏
PauseConfirmLeave=确定?
PauseYes=是
PauseNo=否

[KEYBINDS]
PauseCombat=暂停战斗
LeftMouse=鼠标左键
RightMouse=鼠标右键
MiddleMouse=鼠标中键
MouseWheel=鼠标滚轮
CameraLeft=视角左转
CameraRight=视角右转
CameraUp=视角向下
CameraDown=视角向上
ZoomIn=放大
ZoomOut=缩小
DragCamera=视角移动
FireWeapon=开火
TargetMode=目标模式
TargetNearestAir=选择最近的飞机
NavigationMode=导航模式
SelectMode=选择模式
ChaseCam=视角跟随
FollowCam=视角跟随目标
Cancel=取消
Map=打开地图
MapSize=小地图
LockMap=锁定地图
Binoculars=望远镜/潜望镜
TimeCompression=时间加速
HideUI=隐藏UI
FreezeCamera=冻结视角
SwitchUnderwater=水下视角

AttackTarget=攻击

LeftRudder=左转
RightRudder=右转
MoveUp=上升
MoveDown=下降
ZeroControls=回正
IncreaseSpeed=加速
DecreaseSpeed=减速

Menu=菜单
UnitID=检视
Orders=指令
DamageControl=损管
Weap0=主炮|机枪
Weap1=副炮|炸弹
Weap2=鱼雷
Weap3=鱼雷
Weap4=深弹|火箭弹
Weap5=刺猬弹|投弹舱门
Weap6=乌贼弹|全部投下
Weap7=神风
Weap8=--
Weap9=--
RadarOnOff=雷达
ActiveSonarOnOff=主动声呐

MessageLog=消息日志

SelectUnit=选择单位
AddUnit=添加单位
CampSummary=自定义战役编辑器
CampUnitID=检视单位
NextMobile=下个单位
NextLocation=下个地点
CentreMap=地图居中
ToggleSea=显示海上单位
ToggleAir=显示空中单位
ToggleLocation=显示地点
ToggleContact=显示敌方信息
ToggleWeather=显示天气
ToggleMapLabel=显示地图标签
TimeBack=时间减速
TimePause=暂停
TimeForward=时间加速
TimeMax=最大加速

CustomSummary=设置
CustomUnitID=检视&添加单位
CustomNextMobile=下个单位

MapRuler=显示图例
MapMarker=添加标记
NextFilteredMobile=下个单位
NextFriendlyLocation=下个地点